甖	罌
叫	呌
煙	𤎆
鬥	鬭
齧	囓
鵶	鴉
絃	弦
為	爲
裏	裡
𠦁	斗
駞	駝
茜	蒨
蔕	蒂
㦲	哉
勲	勳
蹌	蹡
䝉	蒙
肯	肻
𩲸	魄
窗	窻
樝	楂
疎	疏
徧	遍
澁	澀
斡	𠏉
搗	擣
陞	升
縆	緪
粧	妝
綫	線
荳	豆
飡	餐
豗	𧱉
巗	巖
峰	峯
鸎	鶯
峩	峨
牋	箋
挿	插
㗸	銜
唇	脣
儁	俊
逓	遞
寳	寶
塚	冢